EA xpms/chips_64.xpm

NO       xpms/wall64x64.xpm

SO    xpms/mario_64.xpm

WE   xpms/chips_64.xpm




F      0        ,    0,       255


C   0,255,0


        1111111111111111111111111
        1000000000110000000000001
        1011000001110000000000001
        1001000000000000000000001
111111111011000001110000000000001
100000000011000001110111111111111
11110111111111011100000010001
1111C111111111011101010010001
11000000110101011100000010001
100000N0000100001100000010001
 
10000000001000001101010010001
110000011101010111110111100111
11110111 1110101 10111101CC1
11111111 1111111 111111111111
111111111111111111111111111


