NO       ./path_to_the_north_texture
SO ./path_to_the_south_texture
WE   ./path_to_the_west_texture

EA ./path_to_the_east_texture


F   22 ,1  ,0


C   225,30,0

                   111111111111111111
               11110000000000000000001111
            11100000000000000000000000000111
         11100000000000000000000000000000000111
       111000000000000000000000000000000000000111
     1110000000000000000000000000000000000000000111
    111000000000000000000000000000000000000000000111
   11100000000000000000000000000000000000000000000111                  11111111111111111111111111111111111111111111111111111111111111111111111111111111111
  1110000000000000000000000000000000000000000000000111        111111111111111111111100000000000000000000000000000000000000000000000000000000000000000000000
  1110000000000000000000000000000000000000000000000111  111111111111110000000000000000000000000000000000000000000000000000000000000000000000000000000000000
  111000000000000000000000000000000000000000000000011111111111100000000000000000000000000000000000000000000000000000000000000000000000000000000000000000000
  111000000000000000000000000000000000000000000000011111111110000000000000000000000000000000000000000000000000000000000000000000000000000000000000000000000
  111000000000000000000000000000000000000000000000011111111000000000000000000000000000000000000000000000000000000000000000000000000000000000000000000000000
   11100000000000000000000000000000000000000000000111111000000000000000000000000000000000000000000000000000000000000000000000000000000000000000000000000000
    1110000000000000000000000000000000000000000001110000000000000000000000000000000000000000000000000000000000000000000000000000000000000000000000000000000
     111000000000000000000000000000000000000000011100000000000000000000000000000000000000000000000000000000000000000000000000000000000000000000000000000000
       1110000000000000000000000000000000000001110000000000000000000000000000000000000000000000000000000000000000000000000000000000000000000000000000000000
        111000000000000000000000000000000001110000000000000000000000000000000000000000000000000000000000000000000000000000000000000000000000000000000000000
           111100000000000000000000000000111000000000000000000000000000000000000000000000000000000000000000000000000000000000000000000000000000000000000000
               11110000000000000000001111000000000000000000000000000000000000000000000000000000000000000000000000000000000000000000000000000000000000000000
                   1111111111111111110000000000000000000000000000000000000000000000000000000000000000000000000000000000000000000000000000000000000000000000
               11110000000000000000001111000000000000000000000000000000000000000000000000000000000000000000000000000000000000000000000000000000000000000000
            11100000000000000000000000000111000000000000000000000000000000000000000000000000000000000000000000000000000000000000000000000000000000000000000
         11100000000000000000000000000000000111000000000000000000000000000000000000000000000000000000000000000000000000000000000000000000000000000000000000
       1110000000000000000000000000000000000001110000000000000000000000000000000000000000000000000000000000000000000000000000000000000000000000000000000000
     111000000000000000000000000000000000000000011100000000000000000000000000000000000000000000000000000000000000000000000000000000000000000000000000000000
    1110000000000000000000000000000000000000000001111111000000000000000000000000000000000000000000000000000000000000000000000000000000000000000000000000000
   11100000000000000000000000000000000000000000000111111111000000000000000000000000000000000000000000000000000000000000000000000000000000000000000000000000
  111000000000000000000000000000000000000000000000011111111110000000000000000000000000000000000000000000000000000000000000000000000000000000000000000000000
  111000000000000000000000000000000000000000000000011111111111100000000000000000000000000000000000000000000000000000000000000000000000000000000000000000000
  1110000000000000000000000000000000000000000000000111  111111111111111110000000000000000000000000000000000000000000000000000000000000000000000000000000000
  1110000000000000000000000000000000000000000000000111        111111111111111111111100000000000000000000000000000000000000000000000000000000000000000000000
  1110000000000000000000000000000000000000000000000111                  11111111111111111111111111111111111111111111111111111111111111111111111111111111111
   11100000000000000000000000000000000000000000000111
    111000000000000000000000000000000000000000000111
     1110000000000000000000000000000000000000000111
       111000000000000000000000000000000000000111
        11100000000000000000000000000000000111
           111100000000000000000000000000111
               11110000000000000000001111
                   111111111111111111