NO       ./path_to_the_north_texture
SO ./path_to_the_south_texture
WE   ./path_to_the_west_texture

EA ./path_to_the_east_texture


F   110,100,100


C   111,30,0

11111
10101
10001
10E01
11111