NO       xpms/tile27.xpm
SO xpms/grass64x64.xpm
WE   xpms/wall64x64.xpm

EA xpms/exit64x64.xpm

C 111,30,0
F  111,110,100

11111
10101
10011
10N01
11111















