NO       xpms/ommohame.xpm
EA xpms/mmassarw.xpm
WE   xpms/jebucoy.xpm

SO xpms/oabdalla.xpm

C 111,30,0
F  111,110,100

111111
100001
100001
100001
100001
100001
100001
100001
100001
100001
100001
100001
100001
10N001
111111















